,phone,email,address,url,hobby,sum,threshold
0,266,63,167,78,472,1046,0.54
1,270,66,170,80,472,1058,0.59
2,271,70,173,80,472,1066,0.64
3,273,71,175,80,473,1072,0.69
4,276,76,176,81,473,1082,0.74
5,279,82,179,83,476,1099,0.79
6,285,87,188,88,478,1126,0.84
7,293,96,209,94,483,1175,0.89
8,308,140,262,104,490,1304,0.94
9,389,321,492,132,498,1832,0.99
