,hobby,phone,email,address,url,sum,threshold
0,274,11,22,12,17,336,0.54
1,226,11,21,12,14,284,0.59
2,196,10,19,11,11,247,0.64
3,169,10,18,10,8,215,0.69
4,142,10,14,10,8,184,0.74
5,114,8,13,10,6,151,0.79
6,81,8,10,9,5,113,0.84
7,60,6,6,8,4,84,0.89
8,31,2,5,6,3,47,0.94
9,3,0,1,1,3,8,0.99
