,hobby,phone,email,address,url,sum,threshold
0,28,225,435,346,61,1095,0.54
1,27,223,434,345,60,1089,0.59
2,27,223,431,340,60,1081,0.64
3,27,220,428,338,59,1072,0.69
4,26,217,425,335,59,1062,0.74
5,25,212,417,333,58,1045,0.79
6,22,200,411,320,54,1007,0.84
7,15,195,401,298,46,955,0.89
8,10,173,369,244,39,835,0.94
9,2,100,177,9,8,296,0.99
